0000000000
0030000000
2222200000
0000000000
0000010000
0200220000
0000220020
0000000000
0000222222
0000000000