2000200020
0030000200
0000000000
0200202000
0000010000
0000202000
0020000200
0200000002
0000200200
2000200002