0200210020
0000000200
0000000000
0022022200
0000000200
0020000000
0022202200
0000000002
0000200200
0020000003